############
#         O#
# P     ####
#          #
#######    #
#   O##    #
#   ###    #
#          #
#       XX #
#       #  #
###########A